#...............................#
#...............................#
#...............................#
#...............................#
#...............................#
#................#####..........#
#...............................#
#...............................#
#################################